15 15
9 10 8 1386 1738 44 841 1768 8 680 842 106 40 842 172 
5 2027 6 9 1514 838 3 4 5 833 620 29 2021 557 837 
3 8 1838 1733 11 938 12 1317 5 1733 3 834 834 6 1893 
1325 835 1772 1889 842 14 417 4 1509 933 11 10 938 842 4 
833 1736 2 6 617 12 1729 6 5 5 9 840 1836 557 5 
1765 3 12 1385 4 837 673 844 1893 97 1728 1254 7 1 1508 
1 12 3 4 1731 2020 7 1313 0 6 3 8 12 7 1733 
37 1505 556 1249 108 3 8 4 7 169 1384 4 417 10 102 
5 1 838 1733 3 840 928 36 11 2 6 7 3 618 556 
103 7 425 610 1324 1 6 1891 840 12 1325 841 840 12 837 
843 10 4 11 834 672 12 9 36 2019 4 3 1764 5 933 
1835 8 1250 10 172 7 421 833 4 13 161 8 2 1248 6 
9 1732 1385 12 835 10 2 162 610 4 1731 1378 556 3 12 
2017 676 5 1733 9 1772 841 12 11 2 10 1518 7 843 1828 
835 2 838 419 6 1731 1830 3 682 10 1898 842 10 1258 6 
